11111111111111111111111111111
1001011001100011C100110110P01
10C10000000000110000000000001
101000101C1010110001010100011
10000111111110000101111110011
10000000000C10000111000110011
10000101111010011111C10110001
100001C0000000011111110011001
10000111111110C111110100C1001
10100101C10100000010000011001
10100000000000000000111110001
10100000000000110000101010001
10100000000000111000000000001
10101101101100110011011011101
1E10010C100101C001C00000C01C1
11111111111111111111111111111