111111111111111
1P0001000000001
111100100111001
100001001111C01
101110001111101
101000011110001
101010101100001
101001000100001
100010000001111
1C0100000110C01
111000111000101
100000000011101
10011110111E001
10000C11C000001
111111111111111